"Position","Club","Matches","Wins","Draws","Losses","GoalsScored","GoalsConceded","GoalDiff","Points"
"1","Chelsea",38,30,3,5,85,33,52,93
"2","Tottenham",38,26,8,4,86,26,60,86
"3","Man City",38,23,9,6,80,39,41,78
"4","Liverpool",38,22,10,6,78,42,36,76
"5","Arsenal",38,23,6,9,77,44,33,75
"6","Man Utd",38,18,15,5,54,29,25,69
"7","Everton",38,17,10,11,62,44,18,61
"8","Southampton",38,12,10,16,41,48,-7,46
"9","Bournemouth",38,12,10,16,55,67,-12,46
"10","West Brom",38,12,9,17,43,51,-8,45
"11","West Ham",38,12,9,17,47,64,-17,45
"12","Leicester",38,12,8,18,48,63,-15,44
"13","Stoke",38,11,11,16,41,56,-15,44
"14","Crystal Palace",38,12,5,21,50,63,-13,41
"15","Swansea",38,12,5,21,45,70,-25,41
"16","Burnley",38,11,7,20,39,55,-16,40
"17","Watford",38,11,7,20,40,68,-28,40
"18","Hull",38,9,7,22,37,80,-43,34
"19","Middlesbrough",38,5,13,20,27,53,-26,28
"20","Sunderland",38,6,6,26,29,69,-40,24
